"dU" = (/obj/structure/flora/ausbushes/stalkybush,/turf/simulated/floor/holofloor/grass,/area/space)
"eg" = (/obj/structure/table/woodentable,/obj/structure/window/reinforced/treated{dir = 1},/obj/item/weapon/gun/projectile/revolver/mateba,/turf/simulated/floor/holofloor/tiled/dark,/area/space)
"fM" = (/obj/structure/table/woodentable,/turf/simulated/floor/holofloor/tiled/dark,/area/space)
"gR" = (/obj/structure/flora/ausbushes/fernybush,/turf/simulated/floor/holofloor/grass,/area/space)
"jS" = (/obj/machinery/door/airlock/multi_tile/glass,/turf/simulated/floor/holofloor/tiled/dark,/area/space)
"lY" = (/obj/structure/flora/ausbushes/genericbush,/turf/simulated/floor/holofloor/grass,/area/space)
"nd" = (/obj/structure/window/framed/external,/turf/simulated/floor/reinforced,/area/space)
"ng" = (/obj/structure/window/framed/external,/turf/simulated/floor/holofloor/tiled/dark,/area/space)
"nw" = (/obj/structure/flora/ausbushes/ywflowers,/turf/simulated/floor/holofloor/grass,/area/space)
"pI" = (/turf/simulated/floor/holofloor/grass,/area/space)
"qB" = (/turf/simulated/floor/stairs/west,/area/space)
"qE" = (/obj/structure/flora/ausbushes/sunnybush,/turf/simulated/floor/holofloor/grass,/area/space)
"qN" = (/obj/structure/table/woodentable,/obj/structure/window/reinforced/treated{dir = 1},/obj/structure/window/reinforced/treated{dir = 4},/turf/simulated/floor/holofloor/tiled/dark,/area/space)
"ta" = (/obj/structure/table/woodentable,/obj/random/drinkbottle,/turf/simulated/floor/holofloor/tiled/dark,/area/space)
"wD" = (/turf/simulated/floor/water,/area/space)
"xh" = (/obj/structure/tree/three,/turf/simulated/floor/holofloor/grass,/area/space)
"xC" = (/turf/simulated/wall/r_wall,/area/space)
"xN" = (/turf/simulated/floor/lino,/area/space)
"Ad" = (/turf/simulated/floor/stairs/north,/area/space)
"CO" = (/obj/machinery/door/airlock/multi_tile/glass{dir = 8},/turf/simulated/floor/lino,/area/space)
"EV" = (/turf/simulated/floor/holofloor/tiled/dark,/area/space)
"FC" = (/obj/structure/window/reinforced/treated{dir = 2},/turf/simulated/floor/reinforced,/area/space)
"GS" = (/turf/simulated/floor/carpet,/area/space)
"Hm" = (/turf/simulated/floor/pavement/empty,/area/space)
"Hs" = (/obj/structure/table/woodentable,/obj/item/weapon/form_printer,/obj/item/weapon/folder/yellow,/turf/simulated/floor/holofloor/tiled/dark,/area/space)
"Ig" = (/obj/structure/table/woodentable,/obj/item/pizzabox/meat,/turf/simulated/floor/holofloor/tiled/dark,/area/space)
"Kg" = (/turf/simulated/floor/stairs,/area/space)
"Kv" = (/obj/structure/table/woodentable,/obj/structure/window/reinforced/treated{dir = 1},/obj/random/contraband,/turf/simulated/floor/holofloor/tiled/dark,/area/space)
"Mt" = (/obj/item/target,/turf/simulated/floor/reinforced,/area/space)
"Pb" = (/obj/structure/table/woodentable,/obj/structure/window/reinforced/treated{dir = 1},/obj/item/nav_data_chip/fragmented/innie,/turf/simulated/floor/holofloor/tiled/dark,/area/space)
"Qu" = (/obj/structure/tree/rand,/turf/simulated/floor/holofloor/grass,/area/space)
"QZ" = (/turf/simulated/floor/reinforced,/area/space)
"Vf" = (/obj/item/target,/obj/structure/window/reinforced/treated{dir = 2},/turf/simulated/floor/reinforced,/area/space)
"WV" = (/obj/structure/tree/two,/turf/simulated/floor/holofloor/grass,/area/space)
"WZ" = (/turf/simulated/floor/stairs/east,/area/space)
"YN" = (/obj/machinery/door/airlock/multi_tile/glass{dir = 8},/turf/simulated/floor/holofloor/tiled/dark,/area/space)

(1,1,1) = {"
wDwDwDwDwDwDwDwDwDwDwDwDwDwDwDwDwDwDwDwDwDwDwDwDwDwDwDwDwDwDwDwDwDwDwDwDwDwDwDwDwDwDwDwDwDwDwDwDwDwDwDwDwDwDwDwDwDwDwDwDwDwDwDwDwDwDwDwDwDwDwDwDwDwDwDwDwDwDwDwDwDwDwDwDwDwDwDwDwDwDwDwDwDwDwDwDwDwDwDwD
wDwDwDwDwDwDwDwDwDwDwDwDwDwDwDwDwDwDwDwDwDwDwDwDwDwDwDwDwDwDwDwDwDwDwDwDwDwDwDwDwDwDwDwDwDwDwDwDwDwDwDwDwDwDwDwDwDwDwDwDwDwDwDwDwDwDwDwDwDwDwDwDwDwDwDwDwDwDwDwDwDwDwDwDwDwDwDwDwDwDwDwDwDwDwDwDwDwDwDwD
wDwDwDwDwDwDwDwDwDwDwDwDwDwDwDwDwDwDwDwDwDwDwDwDwDwDwDwDwDwDwDwDwDwDwDwDwDwDwDwDwDwDwDwDwDwDwDwDwDwDwDwDwDwDwDwDwDwDwDwDwDwDwDwDwDwDwDwDwDwDwDwDwDwDwDwDwDwDwDwDwDwDwDwDwDwDwDwDwDwDwDwDwDwDwDwDwDwDwDwD
wDwDwDwDwDwDwDwDwDwDwDwDwDwDwDwDwDwDwDwDwDwDwDwDwDwDwDwDwDwDwDwDwDwDwDwDwDwDwDwDwDwDwDwDwDwDwDwDwDwDwDwDwDwDwDwDwDwDwDwDwDwDwDwDwDwDwDwDwDwDwDwDwDwDwDwDwDwDwDwDwDwDwDwDwDwDwDwDwDwDwDwDwDwDwDwDwDwDwDwD
wDwDwDwDwDwDwDwDwDwDwDwDwDwDwDwDwDwDwDwDwDwDwDwDwDwDwDwDwDwDwDwDwDwDwDwDwDwDwDwDwDwDwDwDwDwDwDwDwDwDwDwDwDwDwDwDwDwDwDwDwDwDwDwDwDwDwDwDwDwDwDwDwDwDwDwDwDwDwDwDwDwDwDwDwDwDwDwDwDwDwDwDwDwDwDwDwDwDwDwD
wDwDwDwDwDwDwDwDwDwDwDwDwDwDwDwDwDwDwDwDwDwDwDwDwDwDwDwDwDwDwDwDwDwDwDwDwDwDwDwDwDwDwDwDwDwDwDwDwDwDwDwDwDwDwDwDwDwDwDwDwDwDwDwDwDwDwDwDwDwDwDwDwDwDwDwDwDwDwDwDwDwDwDwDwDwDwDwDwDwDwDwDwDwDwDwDwDwDwDwD
wDwDwDwDwDwDwDwDwDwDwDwDwDwDwDwDwDwDwDwDwDwDwDwDwDwDwDwDwDwDwDwDwDwDwDwDwDwDwDwDwDwDwDwDwDwDwDwDwDwDwDwDwDwDwDwDwDwDwDwDwDwDwDwDwDwDwDwDwDwDwDwDwDwDwDwDwDwDwDwDwDwDwDwDwDwDwDwDwDwDwDwDwDwDwDwDwDwDwDwD
wDwDwDwDwDwDwDwDwDwDwDwDwDwDwDwDwDwDwDwDwDwDwDwDwDwDwDwDwDwDwDwDwDwDwDwDwDwDwDwDwDwDwDwDwDwDwDwDwDwDwDwDwDwDwDwDwDwDwDwDwDwDwDwDwDwDwDwDwDwDwDwDwDwDwDwDwDwDwDwDwDwDwDwDwDwDwDwDwDwDwDwDwDwDwDwDwDwDwDwD
wDwDwDwDwDwDwDwDwDwDwDwDwDwDwDwDwDwDwDwDwDwDwDwDwDwDwDwDwDwDwDwDwDwDwDwDwDwDwDwDwDwDwDwDwDwDwDwDwDwDwDwDwDwDwDwDwDwDwDwDwDwDwDwDwDwDwDwDwDwDwDwDwDwDwDwDwDwDwDwDwDwDwDwDwDwDwDwDwDwDwDwDwDwDwDwDwDwDwDwD
wDwDwDwDwDwDwDwDwDwDwDwDwDwDwDwDwDxCxCndndndndxCxCxCndndndndxCxCwDwDwDwDwDwDwDwDwDwDwDwDwDwDwDwDwDwDwDwDwDwDwDwDwDwDwDwDwDwDwDwDwDwDwDwDwDwDwDwDwDwDwDwDwDwDwDwDwDwDwDwDwDwDwDwDwDwDwDwDwDwDwDwDwDwDwDwD
wDwDwDwDwDwDwDwDwDwDwDwDwDwDwDwDxCEVEVEVQZQZQZMtxCEVEVEVEVEVEVEVxCwDwDwDwDwDwDwDwDwDwDwDwDwDwDwDwDwDwDwDwDwDwDwDwDwDwDwDwDwDwDwDwDwDwDwDwDwDwDwDwDwDwDwDwDwDwDwDwDwDwDwDwDwDwDwDwDwDwDwDwDwDwDwDwDwDwDwD
wDwDwDwDwDwDwDwDwDwDwDwDwDwDwDxCEVEVHsEVFCFCFCVfxCEVEVEVEVEVEVEVEVxCwDwDwDwDwDwDwDwDwDwDwDwDwDwDwDwDwDwDwDwDwDwDwDwDwDwDwDwDwDwDwDwDwDwDwDwDwDwDwDwDwDwDwDwDwDwDwDwDwDwDwDwDwDwDwDwDwDwDwDwDwDwDwDwDwDwD
wDwDwDwDwDwDwDwDwDwDwDwDwDwDxCEVEVEVfMEVEVEVEVEVxCEVEVEVEVEVEVEVEVEVxCwDwDwDwDwDwDwDwDwDwDwDwDwDwDwDwDwDwDwDwDwDwDwDwDwDwDwDwDwDwDwDwDwDwDwDwDwDwDwDwDwDwDwDwDwDwDwDwDwDwDwDwDwDwDwDwDwDwDwDwDwDwDwDwDwD
wDwDwDwDwDwDwDwDwDwDwDwDwDwDxCEVIgtafMEVEVEVEVEVxCEVEVEVEVEVEVEVEVEVxCwDwDwDwDwDwDwDwDwDwDwDwDwDwDwDwDwDwDwDwDwDwDwDwDwDwDwDwDwDwDwDwDwDwDwDwDwDwDwDwDwDwDwDwDwDwDwDwDwDwDwDwDwDwDwDwDwDwDwDwDwDwDwDwDwD
wDwDwDwDwDwDwDwDwDwDwDwDwDwDndEVEVEVEVEVEVEVEVEVxCEVEVEVEVEVEVEVEVEVndwDwDwDwDwDwDwDwDwDwDwDwDwDwDwDwDwDwDwDwDwDwDwDwDwDwDwDwDwDwDwDwDwDwDwDwDwDwDwDwDwDwDwDwDwDwDwDwDwDwDwDwDwDwDwDwDwDwDwDwDwDwDwDwDwD
wDwDwDwDwDwDwDwDwDwDwDwDwDwDndEVEVEVEVEVEVEVEVEVxCEVEVEVEVEVEVEVEVEVndwDwDwDwDwDwDwDwDwDwDwDwDwDwDwDwDwDwDwDwDwDwDwDwDwDwDwDwDwDwDwDwDwDwDwDxCxCwDwDwDwDwDwDwDwDwDwDwDwDwDwDwDwDwDwDwDwDwDwDwDwDwDwDwDwD
wDwDwDwDwDwDwDwDwDwDwDwDwDwDndEVEVEVEVEVEVEVEVEVxCEVEVEVEVEVEVEVEVEVndwDwDwDwDwDwDwDwDwDwDwDwDwDwDwDwDwDwDwDwDwDwDwDwDwDwDwDwDwDwDwDwDwDwDxCxCxCxCwDwDwDwDwDwDwDwDwDwDwDwDwDwDwDwDwDwDwDwDwDwDwDwDwDwDwD
wDwDwDwDwDwDwDwDwDwDwDwDwDwDxCegPbKvKvqNEVEVEVEVxCEVEVEVEVEVEVEVEVEVxCwDwDwDwDwDwDwDwDwDwDwDwDwDwDwDwDwDwDwDwDwDwDwDwDwDwDwDwDwDwDwDwDwDxCxCxCxCxCxCwDwDwDwDwDwDwDwDwDwDwDwDwDwDwDwDwDwDwDwDwDwDwDwDwDwD
wDwDwDwDwDwDwDwDwDwDwDwDwDwDxCxCxCxCxCxCxCjSEVxCxCxCjSEVxCxCxCxCxCxCxCwDwDwDwDwDwDwDwDwDwDwDwDwDwDwDwDwDwDwDwDwDwDwDwDwDwDwDwDwDwDwDwDxCxCxCxCxCxCxCxCwDwDwDwDwDwDwDwDwDwDwDwDwDwDwDwDwDwDwDwDwDwDwDwDwD
wDwDwDwDwDwDwDwDwDwDwDwDwDwDxCEVEVEVEVxCEVEVEVEVEVEVEVEVEVxCEVEVEVEVxCwDwDwDwDwDwDwDwDwDwDwDwDwDwDwDwDwDwDwDwDwDwDwDwDwDwDwDwDwDwDwDxCxCGSGSAdAdGSGSxCxCwDwDwDwDwDwDwDwDwDwDwDwDwDwDwDwDwDwDwDwDwDwDwDwD
wDwDwDwDwDwDwDwDwDwDwDwDwDwDndEVEVEVEVEVEVEVEVEVEVEVEVEVEVEVEVEVEVEVndwDwDwDwDwDwDwDwDwDwDwDwDwDwDwDwDwDwDwDwDwDwDwDwDwDwDwDwDwDwDxCxCGSGSGSGSGSGSGSGSxCxCwDwDwDwDwDwDwDwDwDwDwDwDwDwDwDwDwDwDwDwDwDwDwD
wDwDwDwDwDwDwDwDwDwDwDwDwDwDndEVEVEVEVYNEVEVEVEVEVEVEVEVEVYNEVEVEVEVndwDwDwDwDwDwDwDwDwDwDwDwDwDwDwDwDwDwDwDwDwDwDwDwDwDwDwDwDwDxCxCGSGSGSGSGSGSGSGSGSGSxCxCwDwDwDwDwDwDwDwDwDwDwDwDwDwDwDwDwDwDwDwDwDwD
wDwDwDwDwDwDwDwDwDwDwDwDwDwDndEVEVEVEVxCEVEVEVEVEVEVEVEVEVxCEVEVEVEVndwDwDwDwDwDwDwDwDwDwDwDwDwDwDwDwDwDwDwDwDwDwDwDwDwDwDwDwDxCxCGSGSGSGSGSGSGSGSGSGSGSGSxCxCwDwDwDwDwDwDwDwDwDwDwDwDwDwDwDwDwDwDwDwDwD
wDwDwDwDwDwDwDwDwDwDwDwDwDwDxCEVEVEVEVxCEVEVEVEVEVEVEVEVEVxCEVEVEVEVxCwDwDwDwDwDwDwDwDwDwDwDwDwDwDwDwDwDwDwDwDwDwDwDwDwDwDwDxCxCGSGSGSGSGSGSGSGSGSGSGSGSGSGSxCxCwDwDwDwDwDwDwDwDwDwDwDwDwDwDwDwDwDwDwDwD
wDwDwDwDwDwDwDwDwDwDwDwDwDwDxCEVEVEVEVxCEVEVxCEVEVEVxCEVEVxCEVEVEVEVxCwDwDwDwDwDwDwDwDwDwDwDwDwDwDwDwDwDwDwDwDwDwDwDwDwDwDxCxCGSGSGSGSGSGSGSGSGSGSGSGSGSGSGSGSxCxCwDwDwDwDwDwDwDwDwDwDwDwDwDwDwDwDwDwDwD
wDwDwDwDwDwDwDwDwDwDwDwDwDwDwDxCEVEVEVxCEVEVxCEVEVEVxCEVEVxCEVEVEVxCwDwDwDwDwDwDwDwDwDwDwDwDwDwDwDwDwDwDwDwDwDwDwDwDwDwDxCxCGSGSGSGSGSGSGSGSGSGSGSGSGSGSGSGSGSGSxCxCwDwDwDwDwDwDwDwDwDwDwDwDwDwDwDwDwDwD
wDwDwDwDwDwDwDwDwDwDwDwDwDwDwDwDxCEVEVxCEVEVxCKgKgKgxCEVEVxCEVEVxCwDwDwDwDwDwDwDwDwDwDwDwDwDwDwDwDwDwDwDwDwDwDwDwDwDwDxCxCWZGSGSGSGSGSGSGSGSGSGSGSGSGSGSGSGSGSGSqBxCxCwDwDwDwDwDwDwDwDwDwDwDwDwDwDwDwDwD
wDwDwDwDwDwDwDwDwDwDwDwDwDwDwDwDwDxCxCxCjSEVxCxCxCxCxCjSEVxCxCxCwDwDwDwDwDwDwDwDwDwDwDwDwDwDwDwDwDwDwDwDwDwDwDwDwDwDwDxCxCWZGSGSGSGSGSGSGSGSGSGSGSGSGSGSGSGSGSGSqBxCxCwDwDwDwDwDwDwDwDwDwDwDwDwDwDwDwDwD
wDwDwDwDwDwDwDwDwDwDwDwDwDwDwDwDwDwDwDndEVEVndwDwDwDndEVEVndwDwDwDwDwDwDwDwDwDwDwDwDwDwDwDwDwDwDwDwDwDwDwDwDwDwDwDwDwDwDxCxCGSGSGSGSGSGSGSGSGSGSGSGSGSGSGSGSGSGSxCxCwDwDwDwDwDwDwDwDwDwDwDwDwDwDwDwDwDwD
wDwDwDwDwDwDwDwDwDwDwDwDwDwDwDwDwDwDwDndEVEVndwDwDwDndEVEVndwDwDwDwDwDwDwDwDwDwDwDwDwDwDwDwDwDwDwDwDwDwDwDwDwDwDwDwDwDwDwDxCxCGSGSGSGSGSGSGSGSGSGSGSGSGSGSGSGSxCxCwDwDwDwDwDwDwDwDwDwDwDwDwDwDwDwDwDwDwD
wDwDwDwDwDwDwDwDwDwDwDwDwDwDwDwDwDwDwDndEVEVndwDwDwDndEVEVndwDwDwDwDwDwDwDwDwDwDwDwDwDwDwDwDwDwDwDwDwDwDwDwDwDwDwDwDwDwDwDwDxCxCGSGSGSGSGSGSGSGSGSGSGSGSGSGSxCxCwDwDwDwDwDwDwDwDwDwDwDwDwDwDwDwDwDwDwDwD
wDwDwDwDwDwDwDwDwDwDwDwDwDwDwDwDwDwDwDndEVEVndwDwDwDndEVEVndwDwDwDwDwDwDwDwDwDwDwDwDwDwDwDwDwDwDwDwDwDwDwDwDwDwDwDwDwDwDwDwDwDxCxCGSGSGSGSGSGSGSGSGSGSGSGSxCxCwDwDwDwDwDwDwDwDwDwDwDwDwDwDwDwDwDwDwDwDwD
wDwDwDwDwDwDwDwDwDwDwDwDwDwDwDwDwDwDwDndEVEVndwDwDwDndEVEVndwDwDwDwDwDwDwDwDwDwDwDwDwDwDwDwDwDwDwDwDwDwDwDwDwDwDwDwDwDwDwDwDwDwDxCxCGSGSGSGSGSGSGSGSGSGSxCxCwDwDwDwDwDwDwDwDwDwDwDwDwDwDwDwDwDwDwDwDwDwD
wDwDwDwDwDwDwDwDwDwDwDwDwDwDwDwDwDwDwDndEVEVndwDwDwDndEVEVndwDwDwDwDwDwDwDwDwDwDwDwDwDwDwDwDwDwDwDwDwDwDwDwDwDwDwDwDwDwDwDwDwDwDwDxCxCGSGSGSGSGSGSGSGSxCxCwDwDwDwDwDwDwDwDwDwDwDwDwDwDwDwDwDwDwDwDwDwDwD
wDwDwDwDwDwDwDwDwDwDwDwDwDwDwDwDwDwDwDndEVEVndwDwDwDndEVEVndwDwDwDwDwDwDwDwDwDwDwDwDwDwDwDwDwDwDwDwDwDwDwDwDwDwDwDwDwDwDwDwDwDwDwDwDxCxCxCxCKgKgxCxCxCxCwDwDwDwDwDwDwDwDwDwDwDwDwDwDwDwDwDwDwDwDwDwDwDwD
wDwDwDwDwDwDwDwDwDwDwDwDwDwDwDwDwDwDwDndEVEVndwDwDwDndEVEVndwDwDwDwDwDwDwDwDwDwDwDwDwDwDwDwDwDwDwDwDwDwDwDwDwDwDwDwDwDwDwDwDwDwDwDwDwDxCxCxCxCxCxCxCxCwDwDwDwDwDwDwDwDwDwDwDwDwDwDwDwDwDwDwDwDwDwDwDwDwD
wDwDwDwDwDwDwDwDwDwDwDwDwDwDwDwDwDwDwDndEVEVndwDwDwDndEVEVndwDwDwDwDwDwDwDwDwDwDwDwDwDwDwDwDwDwDwDwDwDwDwDwDwDwDwDwDwDwDwDwDwDwDwDwDwDwDxCxCxCxCxCxCwDwDwDwDwDwDwDwDwDwDwDwDwDwDwDwDwDwDwDwDwDwDwDwDwDwD
wDwDwDwDwDwDwDwDwDwDwDwDwDwDwDwDwDwDwDndEVEVndwDwDwDndEVEVndwDwDwDwDwDwDwDwDwDwDwDwDwDwDwDwDwDwDwDwDwDwDwDwDwDwDwDwDwDwDwDwDwDwDwDwDwDwDwDxCxCxCxCwDwDwDwDwDwDwDwDwDwDwDwDwDwDwDwDwDwDwDwDwDwDwDwDwDwDwD
wDwDwDwDwDwDwDwDwDwDwDwDwDwDwDwDwDwDwDndEVEVndwDwDwDndEVEVndwDwDwDwDwDwDwDwDwDwDwDwDwDwDwDwDwDwDwDwDwDwDwDwDwDwDwDwDwDwDwDwDwDwDwDwDwDwDwDwDxCxCwDwDwDwDwDwDwDwDwDwDwDwDwDwDwDwDwDwDwDwDwDwDwDwDwDwDwDwD
wDwDwDwDwDwDwDwDwDwDwDwDwDwDwDwDwDwDwDndEVEVndwDwDwDndEVEVndwDwDwDwDwDwDwDwDwDwDwDwDwDwDwDwDwDwDwDwDwDwDwDwDwDwDwDwDwDwDwDwDwDwDwDwDwDwDwDwDwDwDwDwDwDwDwDwDwDwDwDwDwDwDwDwDwDwDwDwDwDwDwDwDwDwDwDwDwDwD
wDwDwDwDwDwDwDwDwDxCndndndndndndndndndxCjSEVxCndndndxCjSEVxCndndndndndndndndndxCwDwDwDwDwDwDwDwDwDwDwDwDwDwDwDwDwDwDwDwDwDwDwDwDwDwDwDwDwDwDwDwDwDwDwDwDwDwDwDwDwDwDwDwDwDwDwDwDwDwDwDwDwDwDwDwDwDwDwDwD
wDwDwDwDwDwDwDwDwDndEVEVEVEVEVEVEVEVEVEVEVEVEVEVEVEVEVEVEVEVEVEVEVEVEVEVEVEVEVndwDwDwDwDwDwDwDwDwDwDwDwDwDwDwDwDwDwDwDwDwDwDwDwDwDwDwDwDwDwDwDwDwDwDwDwDwDwDwDwDwDwDwDwDwDwDwDwDwDwDwDwDwDwDwDwDwDwDwDwD
wDwDwDwDwDwDwDwDwDndEVEVEVEVEVEVEVEVEVEVEVEVEVEVEVEVEVEVEVEVEVEVEVEVEVEVEVEVEVndwDwDwDwDwDwDwDwDwDwDwDwDwDwDwDwDwDwDwDwDwDwDwDwDwDwDwDwDwDwDwDwDwDwDwDwDwDwDwDwDwDwDwDwDwDwDwDwDwDwDwDwDwDwDwDwDwDwDwDwD
wDwDwDwDwDwDwDwDwDndEVEVxCxCxCxCxCxCxCxCxCEVEVEVEVEVEVEVxCxCxCxCxCxCxCxCxCEVEVndwDwDwDwDwDwDwDwDwDwDwDwDwDwDwDwDwDwDwDwDwDwDwDwDwDwDwDwDwDwDwDwDwDwDwDwDwDwDwDwDwDwDwDwDwDwDwDwDwDwDwDwDwDwDwDwDwDwDwDwD
wDwDwDwDwDwDwDwDwDndEVEVxCEVEVEVxCKgKgKgxCEVEVEVEVEVEVEVxCKgKgKgxCEVEVEVxCEVEVndwDwDwDwDwDwDwDwDwDwDwDwDwDwDwDwDwDwDwDwDwDwDwDwDwDwDwDwDwDwDwDwDwDwDwDwDwDwDwDwDwDwDwDwDwDwDwDwDwDwDwDwDwDwDwDwDwDwDwDwD
wDwDwDwDwDwDwDwDwDndEVEVxCAdAdAdxCEVEVEVxCEVEVEVEVEVEVEVxCEVEVEVxCAdAdAdxCEVEVndwDwDwDwDwDwDwDwDwDwDwDwDwDwDwDwDwDwDwDwDwDwDwDwDwDwDwDwDwDwDwDwDwDwDwDwDwDwDwDwDwDwDwDwDwDwDwDwDwDwDwDwDwDwDwDwDwDwDwDwD
wDwDwDwDwDwDwDwDwDndEVEVxCEVEVEVxCEVEVEVxCEVEVEVEVEVEVEVxCEVEVEVxCEVEVEVxCEVEVndwDwDwDwDwDwDwDwDwDwDwDwDwDwDwDwDwDwDwDwDwDwDwDwDwDwDwDwDwDwDwDwDwDwDwDwDwDwDwDwDwDwDwDwDwDwDwDwDwDwDwDwDwDwDwDwDwDwDwDwD
wDwDwDwDwDwDwDwDwDxCEVEVEVEVEVEVEVEVEVEVEVEVEVEVEVEVEVEVEVEVEVEVEVEVEVEVEVEVEVxCwDwDwDwDwDwDwDwDwDwDwDwDwDwDwDwDwDwDwDwDwDwDwDwDwDwDwDwDwDwDwDwDwDwDwDwDwDwDwDwDwDwDwDwDwDwDwDwDwDwDwDwDwDwDwDwDwDwDwDwD
wDwDwDwDwDwDwDwDwDndEVEVEVEVEVEVEVEVEVEVEVEVEVEVEVEVEVEVEVEVEVEVEVEVEVEVEVEVEVndwDwDwDwDwDwDwDwDwDwDwDwDwDwDwDwDwDwDwDwDwDwDwDwDwDwDwDwDwDwDwDwDwDwDwDwDwDwDwDwDwDwDwDwDwDwDwDwDwDwDwDwDwDwDwDwDwDwDwDwD
wDwDwDwDwDwDwDwDwDndHmHmHmHmEVEVEVEVEVEVEVEVEVEVEVEVEVEVEVEVEVEVEVEVEVHmHmHmHmndwDwDwDwDwDwDwDwDwDwDwDwDwDwDwDwDwDwDwDwDwDwDwDwDwDwDwDwDwDwDwDwDwDwDwDwDwDwDwDwDwDwDwDwDwDwDwDwDwDwDwDwDwDwDwDwDwDwDwDwD
wDwDwDwDwDwDwDwDwDndHmpIpIHmxCxCxCxCxCxCxCxCxCxNxNxNxCxCxCxCxCxCxCxCxCHmpIpIHmndwDwDwDwDwDwDwDwDwDwDwDwDwDwDwDwDwDwDwDxCxCndndndndndxCxCEVEVEVxCxCndndndndndxCxCwDwDwDwDwDwDwDwDwDwDwDwDwDwDwDwDwDwDwDwD
wDwDwDwDwDwDwDwDwDndHmpIpIHmxCxNxNxNxNxNxNxNxNxNxNxNxNxNxNxNxNxNxNxNxCHmpIpIHmndwDwDwDwDwDwDwDwDwDwDwDwDwDwDwDwDwDwDndEVEVEVEVEVEVEVEVxCEVEVEVxCEVEVEVEVEVEVEVEVndwDwDwDwDwDwDwDwDwDwDwDwDwDwDwDwDwDwDwD
wDwDwDwDwDwDwDwDwDndHmpIpIHmxCxNxNxNxNxNxNxNxNxNxNxNxNxNxNxNxNxNxNxNxCHmpIdUHmndwDwDwDwDwDwDwDwDwDwDwDwDwDwDwDwDwDndEVEVEVEVEVEVEVEVEVxCEVEVEVxCEVEVEVEVEVEVEVEVEVndwDwDwDwDwDwDwDwDwDwDwDwDwDwDwDwDwDwD
wDwDwDwDwDwDwDwDwDndHmWVlYHmxCxNxNxNxNxNxNxNxNxNxNxNxNxNxNxNxNxNxNxNxCHmpIpIHmndwDwDwDwDwDwDwDwDwDwDwDwDwDwDwDwDndEVEVEVEVEVEVEVEVEVEVxCEVEVEVxCEVEVEVEVEVEVEVEVEVEVndwDwDwDwDwDwDwDwDwDwDwDwDwDwDwDwDwD
wDwDwDwDwDwDwDwDwDxCHmpIpIHmxCxNxNxNxNxNxNxNxNxNxNxNxNxNxNxNxNxNxNxNxCHmpIpIHmxCwDwDwDwDwDwDwDwDwDwDwDwDwDwDwDndEVEVEVEVEVEVEVEVEVEVEVxCEVEVEVxCEVEVEVEVEVEVEVEVEVEVEVndwDwDwDwDwDwDwDwDwDwDwDwDwDwDwDwD
wDwDwDwDwDwDwDwDwDxCHmdUpIHmxCxNxNxNxNxNxNxNxNxNxNxNxNxNxNxNxNxNxNxNxCHmQupIHmxCwDwDwDwDwDwDwDwDwDwDwDwDwDwDxCEVEVEVEVEVEVEVEVEVEVEVEVEVEVEVEVEVEVEVEVEVEVEVEVEVEVEVEVEVxCwDwDwDwDwDwDwDwDwDwDwDwDwDwDwD
wDwDwDwDwDwDwDwDwDndHmpIpIHmxCxNxNxNxNxNxNxNxNxNxNxNxNxNxNxNxNxNxNxNxCHmqEpIHmndwDwDwDwDwDwDwDwDwDwDwDwDwDndEVEVEVEVEVEVEVEVEVEVEVEVEVYNEVEVEVYNEVEVEVEVEVEVEVEVEVEVEVEVEVndwDwDwDwDwDwDwDwDwDwDwDwDwDwD
wDwDwDwDwDwDwDwDwDndHmnwpIHmxNxNxNxNxNxNxNxNxNxNxNxNxNxNxNxNxNxNxNxNxNHmpIpIHmndwDwDwDwDwDwDwDwDwDwDwDwDndEVEVEVEVEVEVEVEVEVEVEVEVEVEVxCEVEVEVxCEVEVEVEVEVEVEVEVEVEVEVEVEVEVndwDwDwDwDwDwDwDwDwDwDwDwDwD
wDwDwDwDwDwDwDwDwDndHmpIpIHmCOxNxNxNxNxNxNxNxNxNxNxNxNxNxNxNxNxNxNxNCOHmpIgRHmndwDwDwDwDwDwDwDwDwDwDwDndEVEVEVEVEVEVEVEVEVEVEVEVEVEVEVxCEVEVEVxCEVEVEVEVEVEVEVEVEVEVEVEVEVEVEVndwDwDwDwDwDwDwDwDwDwDwDwD
wDwDwDwDwDwDwDwDwDndHmgRpIHmxCxNxNxNxNxNxNxNxNxNxNxNxNxNxNxNxNxNxNxNxCHmpIpIHmndwDwDwDwDwDwDwDwDwDwDndEVEVEVEVEVEVEVEVEVEVEVEVEVEVEVEVxCEVEVEVxCEVEVEVEVEVEVEVEVEVEVEVEVEVEVEVEVndwDwDwDwDwDwDwDwDwDwDwD
wDwDwDwDwDwDwDwDwDndHmpIpIHmxCxNxNxNxNxNxNxNxNxNxNxNxNxNxNxNxNxNxNxNxCHmpIpIHmndwDwDwDwDwDwDwDwDwDxCEVEVEVEVEVEVEVxCxCxCxCxCxCxCxCxCxCxCEVEVEVxCxCxCxCxCxCxCxCxCxCxCEVEVEVEVEVEVEVxCwDwDwDwDwDwDwDwDwDwD
wDwDwDwDwDwDwDwDwDndHmpIpIHmxCxNxNxNxNxNxNxNxNxNxNxNxNxNxNxNxNxNxNxNxCHmpInwHmngwDwDwDwDwDwDwDwDwDxCEVEVEVEVEVEVEVxCEVEVEVEVEVEVEVEVEVEVEVEVEVEVEVEVEVEVEVEVEVEVEVxCEVEVEVEVEVEVEVxCwDwDwDwDwDwDwDwDwDwD
wDwDwDwDwDwDwDwDwDxCHmxhpIHmxCxNxNxNxNxNxNxNxNxNxNxNxNxNxNxNxNxNxNxNxCHmqEpIHmxCwDwDwDwDwDwDwDwDwDxCEVEVEVEVEVEVEVxCEVEVEVEVEVEVEVEVEVEVEVEVEVEVEVEVEVEVEVEVEVEVEVxCEVEVEVEVEVEVEVxCwDwDwDwDwDwDwDwDwDwD
wDwDwDwDwDwDwDwDwDndHmlYpIHmxCxNxNxNxNxNxNxNxNxNxNxNxNxNxNxNxNxNxNxNxCHmpIpIHmndwDwDwDwDwDwDwDwDwDxCEVEVEVEVEVEVEVxCEVEVEVEVEVEVEVEVEVEVEVEVEVEVEVEVEVEVEVEVEVEVEVxCEVEVEVEVEVEVEVxCwDwDwDwDwDwDwDwDwDwD
wDwDwDwDwDwDwDwDwDndHmpIpIHmxCxNxNxNxNxNxNxNxNxNxNxNxNxNxNxNxNxNxNxNxCHmpIpIHmndwDwDwDwDwDwDwDwDwDxCxCxCxCxCxCxCxCxCEVEVEVxCxCxCxCxCxCxCEVEVEVxCxCxCxCxCxCxCEVEVEVxCxCxCxCxCxCxCxCxCwDwDwDwDwDwDwDwDwDwD
wDwDwDwDwDwDwDwDwDndHmpIpIHmxCxCxCxCxCxCxCxCxCxNxNxNxCxCxCxCxCxCxCxCxCHmWVpIHmndwDwDwDwDwDwDwDwDwDxCEVEVEVEVEVEVEVxCEVEVEVxCEVEVEVEVEVxCEVEVEVxCEVEVEVEVEVxCEVEVEVxCEVEVEVEVEVEVEVxCwDwDwDwDwDwDwDwDwDwD
wDwDwDwDwDwDwDwDwDndHmpIqEHmHmHmHmHmHmHmHmHmHmHmHmHmHmHmHmHmHmHmHmHmHmHmpIpIHmndwDwDwDwDwDwDwDwDwDndEVEVEVEVEVEVEVxCEVEVEVxCEVEVEVEVEVxCEVEVEVxCEVEVEVEVEVxCEVEVEVxCEVEVEVEVEVEVEVndwDwDwDwDwDwDwDwDwDwD
wDwDwDwDwDwDwDwDwDndHmpIpIpIpIpIpIpIpIpIpIdUpIpIgRpIpIpIpIpIpIpIpIpIpIlYpIpIHmndwDwDwDwDwDwDwDwDwDndEVEVEVEVEVEVEVEVEVEVEVEVEVEVEVEVEVxCKgKgKgxCEVEVEVEVEVEVEVEVEVEVEVEVEVEVEVEVEVndwDwDwDwDwDwDwDwDwDwD
wDwDwDwDwDwDwDwDwDndHmnwpIpInwQupIlYpIWVpIpIpIpIpIpIpIqEpIxhpIpIdUQupIpIpIpIHmndwDwDwDwDwDwDwDwDwDndEVEVEVEVEVEVEVYNEVEVEVYNEVEVEVEVEVxCxCxCxCxCEVEVEVEVEVYNEVEVEVYNEVEVEVEVEVEVEVndwDwDwDwDwDwDwDwDwDwD
wDwDwDwDwDwDwDwDwDndHmHmHmHmHmHmHmHmHmHmHmHmHmHmHmHmHmHmHmHmHmHmHmHmHmHmHmHmHmndwDwDwDwDwDwDwDwDwDndEVEVEVEVEVEVEVxCEVEVEVxCEVEVEVEVEVxCEVEVEVxCEVEVEVEVEVxCEVEVEVxCEVEVEVEVEVEVEVndwDwDwDwDwDwDwDwDwDwD
wDwDwDwDwDwDwDwDwDxCndndndndndndxCndndndndndndndxCndndndndndndndxCndndndndndndxCwDwDwDwDwDwDwDwDwDxCEVEVEVEVEVEVEVxCEVEVEVxCEVEVEVEVEVxCKgKgKgxCEVEVEVEVEVxCEVEVEVxCEVEVEVEVEVEVEVxCwDwDwDwDwDwDwDwDwDwD
wDwDwDwDwDwDwDwDwDwDwDwDwDwDwDwDwDwDwDwDwDwDwDwDwDwDwDwDwDwDwDwDwDwDwDwDwDwDwDwDwDwDwDwDwDwDwDwDwDxCxCxCxCxCxCxCxCxCEVEVEVxCxCxCxCxCxCxCEVEVEVxCxCxCxCxCxCxCEVEVEVxCxCxCxCxCxCxCxCxCwDwDwDwDwDwDwDwDwDwD
wDwDwDwDwDwDwDwDwDwDwDwDwDwDwDwDwDwDwDwDwDwDwDwDwDwDwDwDwDwDwDwDwDwDwDwDwDwDwDwDwDwDwDwDwDwDwDwDwDxCEVEVEVEVEVEVEVxCEVEVEVxCEVEVEVEVEVxCEVEVEVxCEVEVEVEVEVxCEVEVEVxCEVEVEVEVEVEVEVxCwDwDwDwDwDwDwDwDwDwD
wDwDwDwDwDwDwDwDwDwDwDwDwDwDwDwDwDwDwDwDwDwDwDwDwDwDwDwDwDwDwDwDwDwDwDwDwDwDwDwDwDwDwDwDwDwDwDwDwDndEVEVEVEVEVEVEVxCEVEVEVxCEVEVEVEVEVxCEVEVEVxCEVEVEVEVEVxCEVEVEVxCEVEVEVEVEVEVEVndwDwDwDwDwDwDwDwDwDwD
wDwDwDwDwDwDwDwDwDwDwDwDwDwDwDwDwDwDwDwDwDwDwDwDwDwDwDwDwDwDwDwDwDwDwDwDwDwDwDwDwDwDwDwDwDwDwDwDwDndEVEVEVEVEVEVEVEVEVEVEVEVEVEVEVEVEVxCEVEVEVxCEVEVEVEVEVEVEVEVEVEVEVEVEVEVEVEVEVndwDwDwDwDwDwDwDwDwDwD
wDwDwDwDwDwDwDwDwDwDwDwDwDwDwDwDwDwDwDwDwDwDwDwDwDwDwDwDwDwDwDwDwDwDwDwDwDwDwDwDwDwDwDwDwDwDwDwDwDndEVEVEVEVEVEVEVYNEVEVEVYNEVEVEVEVEVxCEVEVEVxCEVEVEVEVEVYNEVEVEVYNEVEVEVEVEVEVEVndwDwDwDwDwDwDwDwDwDwD
wDwDwDwDwDwDwDwDwDwDwDwDwDwDwDwDwDwDwDwDwDwDwDwDwDwDwDwDwDwDwDwDwDwDwDwDwDwDwDwDwDwDwDwDwDwDwDwDwDndEVEVEVEVEVEVEVxCEVEVEVxCEVEVEVEVEVxCEVEVEVxCEVEVEVEVEVxCEVEVEVxCEVEVEVEVEVEVEVndwDwDwDwDwDwDwDwDwDwD
wDwDwDwDwDwDwDwDwDwDwDwDwDwDwDwDwDwDwDwDwDwDwDwDwDwDwDwDwDwDwDwDwDwDwDwDwDwDwDwDwDwDwDwDwDwDwDwDwDndEVEVEVEVEVEVEVxCEVEVEVxCEVEVEVEVEVxCEVEVEVxCEVEVEVEVEVxCEVEVEVxCEVEVEVEVEVEVEVndwDwDwDwDwDwDwDwDwDwD
wDwDwDwDwDwDwDwDwDwDwDwDwDwDwDwDwDwDwDwDwDwDwDwDwDwDwDwDwDwDwDwDwDwDwDwDwDwDwDwDwDwDwDwDwDwDwDwDwDndEVEVEVEVEVEVEVxCEVEVEVxCxCxCxCxCxCxCEVEVEVxCxCxCxCxCxCxCEVEVEVxCEVEVEVEVEVEVEVndwDwDwDwDwDwDwDwDwDwD
wDwDwDwDwDwDwDwDwDwDwDwDwDwDwDwDwDwDwDwDwDwDwDwDwDwDwDwDwDwDwDwDwDwDwDwDwDwDwDwDwDwDwDwDwDwDwDwDwDxCEVEVEVEVEVEVEVxCEVEVEVEVEVEVEVEVEVEVEVEVEVEVEVEVEVEVEVEVEVEVEVxCEVEVEVEVEVEVEVxCwDwDwDwDwDwDwDwDwDwD
wDwDwDwDwDwDwDwDwDwDwDwDwDwDwDwDwDwDwDwDwDwDwDwDwDwDwDwDwDwDwDwDwDwDwDwDwDwDwDwDwDwDwDwDwDwDwDwDwDxCEVEVEVEVEVEVEVxCEVEVEVEVEVEVEVEVEVEVEVEVEVEVEVEVEVEVEVEVEVEVEVxCEVEVEVEVEVEVEVxCwDwDwDwDwDwDwDwDwDwD
wDwDwDwDwDwDwDwDwDwDwDwDwDwDwDwDwDwDwDwDwDwDwDwDwDwDwDwDwDwDwDwDwDwDwDwDwDwDwDwDwDwDwDwDwDwDwDwDwDwDndEVEVEVEVEVEVxCEVEVEVEVEVEVEVEVEVEVEVEVEVEVEVEVEVEVEVEVEVEVEVxCEVEVEVEVEVEVndwDwDwDwDwDwDwDwDwDwDwD
wDwDwDwDwDwDwDwDwDwDwDwDwDwDwDwDwDwDwDwDwDwDwDwDwDwDwDwDwDwDwDwDwDwDwDwDwDwDwDwDwDwDwDwDwDwDwDwDwDwDwDndEVEVEVEVEVxCxCxCxCxCxCxCjSEVxCxCEVEVEVxCxCjSEVxCxCxCxCxCxCxCEVEVEVEVEVndwDwDwDwDwDwDwDwDwDwDwDwD
wDwDwDwDwDwDwDwDwDwDwDwDwDwDwDwDwDwDwDwDwDwDwDwDwDwDwDwDwDwDwDwDwDwDwDwDwDwDwDwDwDwDwDwDwDwDwDwDwDwDwDwDndEVEVEVEVEVEVEVEVxCEVEVEVEVEVxCEVEVEVxCEVEVEVEVEVxCEVEVEVEVEVEVEVEVndwDwDwDwDwDwDwDwDwDwDwDwDwD
wDwDwDwDwDwDwDwDwDwDwDwDwDwDwDwDwDwDwDwDwDwDwDwDwDwDwDwDwDwDwDwDwDwDwDwDwDwDwDwDwDwDwDwDwDwDwDwDwDwDwDwDwDndEVEVEVEVEVEVEVxCEVEVEVEVEVxCEVEVEVxCEVEVEVEVEVxCEVEVEVEVEVEVEVndwDwDwDwDwDwDwDwDwDwDwDwDwDwD
wDwDwDwDwDwDwDwDwDwDwDwDwDwDwDwDwDwDwDwDwDwDwDwDwDwDwDwDwDwDwDwDwDwDwDwDwDwDwDwDwDwDwDwDwDwDwDwDwDwDwDwDwDwDxCEVEVEVEVEVEVxCEVEVEVEVEVxCEVEVEVxCEVEVEVEVEVxCEVEVEVEVEVEVxCwDwDwDwDwDwDwDwDwDwDwDwDwDwDwD
wDwDwDwDwDwDwDwDwDwDwDwDwDwDwDwDwDwDwDwDwDwDwDwDwDwDwDwDwDwDwDwDwDwDwDwDwDwDwDwDwDwDwDwDwDwDwDwDwDwDwDwDwDwDwDndEVEVEVEVEVxCEVEVEVEVEVxCEVEVEVxCEVEVEVEVEVxCEVEVEVEVEVndwDwDwDwDwDwDwDwDwDwDwDwDwDwDwDwD
wDwDwDwDwDwDwDwDwDwDwDwDwDwDwDwDwDwDwDwDwDwDwDwDwDwDwDwDwDwDwDwDwDwDwDwDwDwDwDwDwDwDwDwDwDwDwDwDwDwDwDwDwDwDwDwDndEVEVEVEVxCEVEVEVEVEVxCEVEVEVxCEVEVEVEVEVxCEVEVEVEVndwDwDwDwDwDwDwDwDwDwDwDwDwDwDwDwDwD
wDwDwDwDwDwDwDwDwDwDwDwDwDwDwDwDwDwDwDwDwDwDwDwDwDwDwDwDwDwDwDwDwDwDwDwDwDwDwDwDwDwDwDwDwDwDwDwDwDwDwDwDwDwDwDwDwDndEVEVEVxCEVEVEVEVEVxCEVEVEVxCEVEVEVEVEVxCEVEVEVndwDwDwDwDwDwDwDwDwDwDwDwDwDwDwDwDwDwD
wDwDwDwDwDwDwDwDwDwDwDwDwDwDwDwDwDwDwDwDwDwDwDwDwDwDwDwDwDwDwDwDwDwDwDwDwDwDwDwDwDwDwDwDwDwDwDwDwDwDwDwDwDwDwDwDwDwDndEVEVxCEVEVEVEVEVxCEVEVEVxCEVEVEVEVEVxCEVEVndwDwDwDwDwDwDwDwDwDwDwDwDwDwDwDwDwDwDwD
wDwDwDwDwDwDwDwDwDwDwDwDwDwDwDwDwDwDwDwDwDwDwDwDwDwDwDwDwDwDwDwDwDwDwDwDwDwDwDwDwDwDwDwDwDwDwDwDwDwDwDwDwDwDwDwDwDwDwDxCxCxCxCndndndxCxCndndndxCxCndndndxCxCxCxCwDwDwDwDwDwDwDwDwDwDwDwDwDwDwDwDwDwDwDwD
wDwDwDwDwDwDwDwDwDwDwDwDwDwDwDwDwDwDwDwDwDwDwDwDwDwDwDwDwDwDwDwDwDwDwDwDwDwDwDwDwDwDwDwDwDwDwDwDwDwDwDwDwDwDwDwDwDwDwDwDwDwDwDwDwDwDwDwDwDwDwDwDwDwDwDwDwDwDwDwDwDwDwDwDwDwDwDwDwDwDwDwDwDwDwDwDwDwDwDwD
wDwDwDwDwDwDwDwDwDwDwDwDwDwDwDwDwDwDwDwDwDwDwDwDwDwDwDwDwDwDwDwDwDwDwDwDwDwDwDwDwDwDwDwDwDwDwDwDwDwDwDwDwDwDwDwDwDwDwDwDwDwDwDwDwDwDwDwDwDwDwDwDwDwDwDwDwDwDwDwDwDwDwDwDwDwDwDwDwDwDwDwDwDwDwDwDwDwDwDwD
wDwDwDwDwDwDwDwDwDwDwDwDwDwDwDwDwDwDwDwDwDwDwDwDwDwDwDwDwDwDwDwDwDwDwDwDwDwDwDwDwDwDwDwDwDwDwDwDwDwDwDwDwDwDwDwDwDwDwDwDwDwDwDwDwDwDwDwDwDwDwDwDwDwDwDwDwDwDwDwDwDwDwDwDwDwDwDwDwDwDwDwDwDwDwDwDwDwDwDwD
wDwDwDwDwDwDwDwDwDwDwDwDwDwDwDwDwDwDwDwDwDwDwDwDwDwDwDwDwDwDwDwDwDwDwDwDwDwDwDwDwDwDwDwDwDwDwDwDwDwDwDwDwDwDwDwDwDwDwDwDwDwDwDwDwDwDwDwDwDwDwDwDwDwDwDwDwDwDwDwDwDwDwDwDwDwDwDwDwDwDwDwDwDwDwDwDwDwDwDwD
wDwDwDwDwDwDwDwDwDwDwDwDwDwDwDwDwDwDwDwDwDwDwDwDwDwDwDwDwDwDwDwDwDwDwDwDwDwDwDwDwDwDwDwDwDwDwDwDwDwDwDwDwDwDwDwDwDwDwDwDwDwDwDwDwDwDwDwDwDwDwDwDwDwDwDwDwDwDwDwDwDwDwDwDwDwDwDwDwDwDwDwDwDwDwDwDwDwDwDwD
wDwDwDwDwDwDwDwDwDwDwDwDwDwDwDwDwDwDwDwDwDwDwDwDwDwDwDwDwDwDwDwDwDwDwDwDwDwDwDwDwDwDwDwDwDwDwDwDwDwDwDwDwDwDwDwDwDwDwDwDwDwDwDwDwDwDwDwDwDwDwDwDwDwDwDwDwDwDwDwDwDwDwDwDwDwDwDwDwDwDwDwDwDwDwDwDwDwDwDwD
wDwDwDwDwDwDwDwDwDwDwDwDwDwDwDwDwDwDwDwDwDwDwDwDwDwDwDwDwDwDwDwDwDwDwDwDwDwDwDwDwDwDwDwDwDwDwDwDwDwDwDwDwDwDwDwDwDwDwDwDwDwDwDwDwDwDwDwDwDwDwDwDwDwDwDwDwDwDwDwDwDwDwDwDwDwDwDwDwDwDwDwDwDwDwDwDwDwDwDwD
wDwDwDwDwDwDwDwDwDwDwDwDwDwDwDwDwDwDwDwDwDwDwDwDwDwDwDwDwDwDwDwDwDwDwDwDwDwDwDwDwDwDwDwDwDwDwDwDwDwDwDwDwDwDwDwDwDwDwDwDwDwDwDwDwDwDwDwDwDwDwDwDwDwDwDwDwDwDwDwDwDwDwDwDwDwDwDwDwDwDwDwDwDwDwDwDwDwDwDwD
wDwDwDwDwDwDwDwDwDwDwDwDwDwDwDwDwDwDwDwDwDwDwDwDwDwDwDwDwDwDwDwDwDwDwDwDwDwDwDwDwDwDwDwDwDwDwDwDwDwDwDwDwDwDwDwDwDwDwDwDwDwDwDwDwDwDwDwDwDwDwDwDwDwDwDwDwDwDwDwDwDwDwDwDwDwDwDwDwDwDwDwDwDwDwDwDwDwDwDwD
"}

